           +------------------+                         
 +----+    |..................|         +------------+  
 |....|    |..................|         |............|  
 |....+----+.....+------+.....|         |............|  
 |...............|      |.....###########....+---+...|  
 |...............|      |.....|         |....|   |...|  
 +-+.............|      |.....|         |....|   |...|  
   |.............|      |.....|         |....+---+...|  
   +-+...........|      +-#---+         |............|  
     |...........|        #             +--------#---+  
     +----#------+        #                      #      
          #         +-----#--+                +--#-----+
          #         |........|                |........|
   +------#-----+   |........|                |........|
   |............|   |..+--+..|                |..+--+..|
   |............|   |..|  |..##################..|  |..|
   |............|   +-#+--+--+                +#-+--+--+
   |............#######          +--------+    #        
   |............|   +-#+--+--+   |........|   +#-+--+--+
   |............|   |..|  |..|   |........|   |..|  |..|
   |............|   |..+--+..|   |........|   |..+--+..|
   |............|   |........|   +----#---+   |........|
   +------------+   |........##################........|
                    +--------+                +--------+
